Id,Label,timeset,indegree,outdegree,degree,weighted indegree,weighted outdegree,weighted degree,Eccentricity,closnesscentrality,harmonicclosnesscentrality,betweenesscentrality,modularity_class,pageranks,clustering,eigencentrality,componentnumber,strongcompnum
"张峰的天狗",张峰的天狗,,0,1,1,0,2,2,1,1,1,0,0,0.001803,0,0,0,1
samuelsg,samuelsg,,2,0,2,3,0,3,0,0,0,0,0,0.004903,0,0.006977,0,0
"透射电子显微镜mooc",透射电子显微镜mooc,,0,1,1,0,1,1,1,1,1,0,0,0.001803,0,0,0,2
"东方之舟",东方之舟,,20,111,131,24,201,225,2,0.916667,0.954545,2725.75,3,0.027497,0.010503,0.602587,1,107
"李俊热爱学习",李俊热爱学习,,1,0,1,1,0,1,0,0,0,0,3,0.002024,0,0.146426,1,106
"西西mooc10",西西mooc10,,0,2,2,0,3,3,3,0.571429,0.708333,0,1,0.001803,0,0,1,109
"谌欣来",谌欣来,,4,2,6,8,3,11,2,0.666667,0.75,26,1,0.004395,0.333333,0.217768,1,97
"梦回丽卡",梦回丽卡,,1,1,2,2,2,4,0,0,0,0,2,0.001803,0,0.006576,2,110
"孜孜不倦mooc15",孜孜不倦mooc15,,1,0,1,1,0,1,0,0,0,0,1,0.002578,0,0.003488,1,108
ljlei1980,ljlei1980,,1,0,1,1,0,1,0,0,0,0,3,0.002024,0,0.146426,1,105
"林龙杰mooc22",林龙杰mooc22,,5,8,13,6,17,23,2,0.9,0.944444,71.883929,3,0.009755,0.054545,0.271569,1,50
mooc1535994962389,mooc1535994962389,,1,1,2,1,4,5,1,1,1,0.8125,13,0.002024,0,0.146426,1,104
"白童童",白童童,,1,1,2,2,2,4,0,0,0,0,4,0.001803,0,0.006576,3,111
xktesla,xktesla,,0,2,2,0,4,4,1,1,1,0,5,0.001803,0.5,0,1,112
16班杨阁文,16班杨阁文,,3,2,5,8,7,15,1,1,1,2.375,5,0.002799,0.333333,0.197095,1,78
"勿与俗同.",勿与俗同.,,0,1,1,0,1,1,1,1,1,0,6,0.001803,0,0,4,114
"杨洲洲",杨洲洲,,1,0,1,1,0,1,0,0,0,0,6,0.003353,0,0.003488,4,113
whoareyoumooc43,whoareyoumooc43,,5,2,7,12,7,19,3,0.5,0.537037,17,3,0.005035,0.3,0.284384,1,50
xd-zlx14-齐淼20009102042,xd-zlx14-齐淼20009102042,,0,1,1,0,1,1,4,0.357143,0.408333,0,3,0.001803,0,0,1,115
"泠慈",泠慈,,0,4,4,0,5,5,4,0.428571,0.5625,0,13,0.001803,0.083333,0,1,116
"青野乾朔",青野乾朔,,3,1,4,3,2,5,1,1,1,0.8125,13,0.002799,0.166667,0.153402,1,42
"陈冬升",陈冬升,,1,4,5,1,6,7,4,0.333333,0.350949,2,3,0.002476,0,0.006576,1,117
mooc1533355248027,mooc1533355248027,,1,3,4,1,4,5,3,0.486166,0.498645,119,3,0.002338,0.166667,0.006576,1,117
"谭俊娇",谭俊娇,,1,0,1,1,0,1,0,0,0,0,3,0.002024,0,0.146426,1,103
"谢媛-MOOC",谢媛-MOOC,,1,5,6,1,8,9,4,0.339888,0.36157,3.633929,3,0.002024,0.166667,0.146426,1,107
"念火",念火,,1,3,4,2,13,15,2,0.8,0.875,4,13,0.003353,0.166667,0.003488,1,119
"上无止境mooc",上无止境mooc,,1,3,4,1,17,18,1,1,1,2,13,0.002777,0.166667,0.005708,1,118
"临床-余一凡-2019级",临床-余一凡-2019级,,1,0,1,1,0,1,0,0,0,0,3,0.002024,0,0.146426,1,102
RAINBOW28,RAINBOW28,,1,0,1,1,0,1,0,0,0,0,3,0.002024,0,0.146426,1,101
"柠檬你好酸",柠檬你好酸,,1,0,1,1,0,1,0,0,0,0,3,0.002024,0,0.146426,1,100
mooc251mgwgd,mooc251mgwgd,,2,1,3,10,2,12,3,0.480159,0.488981,119,3,0.002411,0,0.149914,1,107
HZAU_Mcy,HZAU_Mcy,,1,0,1,1,0,1,0,0,0,0,3,0.002024,0,0.146426,1,99
"管相娥",管相娥,,1,0,1,1,0,1,0,0,0,0,3,0.002024,0,0.146426,1,98
XCU20201010,XCU20201010,,1,2,3,1,4,5,1,1,1,2,1,0.00372,0,0.052796,1,97
"瑞士糖mooc7",瑞士糖mooc7,,1,0,1,1,0,1,0,0,0,0,3,0.002024,0,0.146426,1,96
JenLgd,JenLgd,,1,1,2,2,1,3,3,0.480159,0.488981,0,3,0.002024,0,0.146426,1,107
mooc73090387975491847,mooc73090387975491847,,1,0,1,1,0,1,0,0,0,0,3,0.002024,0,0.146426,1,95
mooc46314553074781154,mooc46314553074781154,,1,0,1,1,0,1,0,0,0,0,3,0.002024,0,0.146426,1,94
"伯齐爸爸",伯齐爸爸,,1,0,1,2,0,2,0,0,0,0,3,0.002024,0,0.146426,1,93
"舞阳阑",舞阳阑,,0,2,2,0,4,4,1,1,1,0,3,0.001803,0,0,1,120
20181401249代振南,20181401249代振南,,2,0,2,6,0,6,0,0,0,0,3,0.002799,0,0.149914,1,92
Liu能学,Liu能学,,4,3,7,7,4,11,2,0.666667,0.75,32,3,0.003403,0.1,0.230886,1,63
Nanika,Nanika,,0,4,4,0,9,9,2,0.7,0.785714,0,13,0.001803,0,0,1,121
Famemooc12,Famemooc12,,1,1,2,2,2,4,0,0,0,0,7,0.001803,0,0.006576,5,122
"一坨蟹子寿司",一坨蟹子寿司,,1,1,2,2,2,4,3,0.480159,0.488981,0,3,0.002024,0,0.146426,1,107
"哔哩老王",哔哩老王,,0,4,4,0,7,7,3,0.666667,0.805556,0,13,0.001803,0.083333,0,1,123
"山河依旧在",山河依旧在,,2,2,4,5,6,11,2,0.75,0.833333,14.8125,13,0.002411,0.166667,0.149914,1,91
ycy66ds,ycy66ds,,2,2,4,2,3,5,1,1,1,3.1875,5,0.002282,0.166667,0.149914,1,90
mooc1535807225995,mooc1535807225995,,1,0,1,2,0,2,0,0,0,0,3,0.002024,0,0.146426,1,89
"落雁mooc3",落雁mooc3,,1,0,1,2,0,2,0,0,0,0,3,0.002024,0,0.146426,1,88
"王迪-4905",王迪-4905,,1,0,1,2,0,2,0,0,0,0,3,0.002024,0,0.146426,1,87
"既见君子云狐不喜",既见君子云狐不喜,,3,0,3,5,0,5,0,0,0,0,3,0.002757,0.166667,0.184552,1,86
"俄众博",俄众博,,1,1,2,3,1,4,1,1,1,0,3,0.002024,0.5,0.146426,1,85
"学霸不是我mooc",学霸不是我mooc,,1,0,1,1,0,1,0,0,0,0,3,0.002024,0,0.146426,1,84
"诗音mooc1",诗音mooc1,,2,1,3,3,1,4,0,0,0,0,3,0.002024,0.5,0.19052,1,83
"包子理",包子理,,1,0,1,1,0,1,0,0,0,0,3,0.002024,0,0.146426,1,82
mooc1524625470709,mooc1524625470709,,1,2,3,2,8,10,1,1,1,3.1875,13,0.002024,0,0.146426,1,81
mooc65234155171089751,mooc65234155171089751,,1,0,1,2,0,2,0,0,0,0,3,0.002024,0,0.146426,1,80
17级生科二班张海卓,17级生科二班张海卓,,1,0,1,2,0,2,0,0,0,0,3,0.002024,0,0.146426,1,79
mcspurs,mcspurs,,3,2,5,5,7,12,3,0.484,0.49449,233.8125,13,0.003145,0.166667,0.187639,1,107
mooc69290120301068825,mooc69290120301068825,,1,2,3,1,2,3,4,0.327957,0.334699,0,13,0.001803,0.5,0.006576,1,124
"生命科学学院王俞娜151314066",生命科学学院王俞娜151314066,,4,1,5,8,4,12,0,0,0,0,3,0.003614,0.333333,0.277808,1,49
hwh2552163com,hwh2552163com,,0,3,3,0,11,11,1,1,1,0,13,0.001803,0,0,1,125
"云mooc693",云mooc693,,1,1,2,2,2,4,0,0,0,0,8,0.001803,0,0.006576,6,126
"海山2号",海山2号,,2,0,2,3,0,3,0,0,0,0,3,0.003012,0.5,0.200823,1,43
"生技1171郑晨禧",生技1171郑晨禧,,1,0,1,1,0,1,0,0,0,0,3,0.002024,0,0.146426,1,77
mooc68365689006433340,mooc68365689006433340,,1,0,1,3,0,3,0,0,0,0,3,0.002024,0,0.146426,1,76
mooc1536767505865,mooc1536767505865,,2,2,4,3,6,9,1,1,1,1,13,0.003353,0.333333,0.013152,1,127
"暖mooc274",暖mooc274,,1,0,1,1,0,1,0,0,0,0,3,0.002024,0,0.146426,1,75
mooc76982555729566720,mooc76982555729566720,,1,0,1,2,0,2,0,0,0,0,3,0.002024,0,0.146426,1,74
mooc43680864252108407,mooc43680864252108407,,1,1,2,2,2,4,0,0,0,0,9,0.001803,0,0.006576,7,128
mooc12771581804156469,mooc12771581804156469,,1,0,1,1,0,1,0,0,0,0,3,0.002024,0,0.146426,1,73
mooc42056312536204026,mooc42056312536204026,,1,0,1,1,0,1,0,0,0,0,3,0.002024,0,0.146426,1,72
mooc11936314571596922,mooc11936314571596922,,1,1,2,3,1,4,3,0.480159,0.488981,0,3,0.002024,0,0.146426,1,107
"什么昵称不被占用",什么昵称不被占用,,1,0,1,1,0,1,0,0,0,0,3,0.002024,0,0.146426,1,71
"小翅膀-徐",小翅膀-徐,,1,1,2,1,1,2,3,0.480159,0.488981,0,3,0.002024,0,0.146426,1,107
yy-Estelle,yy-Estelle,,0,4,4,0,18,18,4,0.333333,0.350271,0,13,0.001803,0.083333,0,1,130
happiness信使,happiness信使,,2,1,3,4,6,10,1,1,1,1,13,0.002965,0.166667,0.006977,1,129
"無訫cc",無訫cc,,0,2,2,0,4,4,2,0.75,0.833333,0,10,0.001803,0,0,1,131
"华生mooc19",华生mooc19,,1,0,1,2,0,2,0,0,0,0,3,0.002024,0,0.146426,1,70
"芝麻小丸子",芝麻小丸子,,0,1,1,0,1,1,1,1,1,0,3,0.001803,0,0,1,132
"雨湿紫花",雨湿紫花,,3,0,3,10,0,10,0,0,0,0,3,0.004109,0,0.15649,1,36
"啦啦啦大米粒子",啦啦啦大米粒子,,1,0,1,2,0,2,0,0,0,0,3,0.002024,0,0.146426,1,69
JiaYuAlice,JiaYuAlice,,1,0,1,1,0,1,0,0,0,0,3,0.002024,0,0.146426,1,68
"李慧巧",李慧巧,,2,0,2,5,0,5,0,0,0,0,3,0.002559,0,0.153001,1,67
"海阔天空nj",海阔天空nj,,1,1,2,2,1,3,3,0.480159,0.488981,0,3,0.002024,0,0.146426,1,107
"梦想飞翔mooc1456689614915",梦想飞翔mooc1456689614915,,1,0,1,1,0,1,0,0,0,0,3,0.002024,0,0.146426,1,66
yanhong69,yanhong69,,1,2,3,1,10,11,1,1,1,3.633929,13,0.002024,0,0.146426,1,65
njnu09150227,njnu09150227,,1,0,1,3,0,3,0,0,0,0,3,0.002024,0,0.146426,1,64
SinYita,SinYita,,2,4,6,3,9,12,2,0.75,0.833333,10.008929,5,0.003012,0.05,0.200823,1,63
mooc76256425342424618,mooc76256425342424618,,0,1,1,0,2,2,2,0.6,0.666667,0,13,0.001803,0,0,1,133
"顾捷成170310108",顾捷成170310108,,5,2,7,10,12,22,1,1,1,10.633929,13,0.00719,0.02381,0.160379,1,61
Agaveman,Agaveman,,1,0,1,2,0,2,0,0,0,0,3,0.002024,0,0.146426,1,60
"雪mooc803",雪mooc803,,1,0,1,2,0,2,0,0,0,0,3,0.002024,0,0.146426,1,59
"大婷儿mooc1",大婷儿mooc1,,1,1,2,2,1,3,3,0.480159,0.488981,0,3,0.002024,0,0.146426,1,107
mooc1507704497147,mooc1507704497147,,1,1,2,1,1,2,2,0.6,0.666667,12,3,0.002024,0,0.146426,1,58
mooc64079941847273009,mooc64079941847273009,,1,0,1,2,0,2,0,0,0,0,3,0.002024,0,0.146426,1,56
"钟晓霞 20181605330128",钟晓霞 20181605330128,,1,0,1,2,0,2,0,0,0,0,3,0.002024,0,0.146426,1,55
2018151621067彭光杰,2018151621067彭光杰,,1,0,1,2,0,2,0,0,0,0,3,0.002024,0,0.146426,1,54
mooc39749753040648183,mooc39749753040648183,,1,0,1,2,0,2,0,0,0,0,3,0.002024,0,0.146426,1,53
"花泽菠菜mooc",花泽菠菜mooc,,1,0,1,1,0,1,0,0,0,0,3,0.002024,0,0.146426,1,52
wkovacs,wkovacs,,1,2,3,1,3,4,1,1,1,3.1875,5,0.002024,0,0.146426,1,51
mooc76373888492404684,mooc76373888492404684,,3,1,4,7,1,8,3,0.5,0.537037,2.25,3,0.00377,0.333333,0.217185,1,50
"惊蛰0",惊蛰0,,1,0,1,1,0,1,0,0,0,0,3,0.002024,0,0.146426,1,48
"我意南风",我意南风,,2,0,2,3,0,3,0,0,0,0,10,0.002799,0,0.149914,1,47
mooc41541050290505302,mooc41541050290505302,,1,0,1,1,0,1,0,0,0,0,3,0.002024,0,0.146426,1,46
"临床五年类180216余琬嵘",临床五年类180216余琬嵘,,1,0,1,2,0,2,0,0,0,0,3,0.002024,0,0.146426,1,45
mooc64473410001217051,mooc64473410001217051,,2,4,6,4,13,17,1,1,1,6.008929,13,0.002024,0.2,0.19052,1,32
zjj95598,zjj95598,,1,0,1,2,0,2,0,0,0,0,3,0.002024,0,0.146426,1,44
Panzerleader,Panzerleader,,0,3,3,0,6,6,2,0.8,0.875,0,13,0.001803,0.166667,0,1,134
"我要上哈佛大学",我要上哈佛大学,,2,1,3,3,2,5,0,0,0,0,3,0.002024,0.5,0.19052,1,41
"应景归尘",应景归尘,,1,2,3,1,5,6,1,1,1,3.633929,13,0.002024,0,0.146426,1,40
jsnu16077136,jsnu16077136,,0,4,4,0,12,12,3,0.666667,0.805556,0,13,0.001803,0,0,1,135
mooc1536545048814,mooc1536545048814,,4,1,5,8,2,10,0,0,0,0,3,0.004729,0.25,0.08835,1,62
"莫问mooc65",莫问mooc65,,2,1,3,3,2,5,0,0,0,0,3,0.002024,0.5,0.19052,1,39
"千秋mooc39",千秋mooc39,,1,1,2,2,1,3,3,0.480159,0.488981,0,3,0.002024,0,0.146426,1,107
"师大17级125班201726602004",师大17级125班201726602004,,2,1,3,3,1,4,0,0,0,0,3,0.002024,0.5,0.19052,1,38
"王翠英mooc",王翠英mooc,,1,1,2,1,2,3,1,1,1,2.375,5,0.002024,0,0.146426,1,37
"姜昭辰18110104",姜昭辰18110104,,1,0,1,1,0,1,0,0,0,0,3,0.002024,0,0.146426,1,35
"龙居士",龙居士,,1,0,1,1,0,1,0,0,0,0,3,0.002024,0,0.146426,1,34
XenoDj,XenoDj,,0,1,1,0,2,2,2,0.6,0.666667,0,13,0.001803,0,0,1,136
Victorr,Victorr,,1,0,1,1,0,1,0,0,0,0,3,0.002024,0,0.146426,1,33
ykt1530843209080,ykt1530843209080,,0,1,1,0,2,2,1,1,1,0,3,0.001803,0,0,1,137
"秦子伊",秦子伊,,0,1,1,0,2,2,2,0.6,0.666667,0,13,0.001803,0,0,1,138
Lanpaz,Lanpaz,,1,1,2,1,2,3,1,1,1,2.375,5,0.002024,0,0.146426,1,31
mooc10168754199472133,mooc10168754199472133,,1,0,1,1,0,1,0,0,0,0,3,0.002024,0,0.146426,1,30
"破茧幻化成蝶mooc27",破茧幻化成蝶mooc27,,1,0,1,1,0,1,0,0,0,0,3,0.002024,0,0.146426,1,29
"骑月钓星",骑月钓星,,3,1,4,5,1,6,0,0,0,0,12,0.002411,0.333333,0.197095,1,28
"姵榕",姵榕,,1,0,1,2,0,2,0,0,0,0,3,0.002024,0,0.146426,1,27
qhu1540301021,qhu1540301021,,1,0,1,1,0,1,0,0,0,0,3,0.002024,0,0.146426,1,26
missingmooc109,missingmooc109,,1,3,4,2,4,6,3,0.49187,0.502755,23.8125,12,0.002024,0.166667,0.146426,1,107
mooc39387639354760419,mooc39387639354760419,,1,0,1,1,0,1,0,0,0,0,3,0.002024,0,0.146426,1,24
"买火车的小女孩",买火车的小女孩,,1,0,1,1,0,1,0,0,0,0,3,0.002024,0,0.146426,1,23
20研二班张宏,20研二班张宏,,2,0,2,3,0,3,0,0,0,0,3,0.003574,0,0.149914,1,22
"郭和熙201726602017",郭和熙201726602017,,0,1,1,0,1,1,1,1,1,0,3,0.001803,0,0,1,139
mooc1496581700091,mooc1496581700091,,1,1,2,3,3,6,0,0,0,0,11,0.001803,0,0.006576,8,140
"誌彣",誌彣,,7,1,8,19,1,20,0,0,0,0,3,0.007371,0.166667,0.260917,1,21
"四眼斑龟教学",四眼斑龟教学,,1,3,4,3,7,10,3,0.49187,0.502755,22.8125,13,0.002024,0.166667,0.146426,1,107
"周袁媛",周袁媛,,1,0,1,1,0,1,0,0,0,0,3,0.002024,0,0.146426,1,17
mooc1519634239112,mooc1519634239112,,1,1,2,1,2,3,3,0.480159,0.488981,0,3,0.002024,0,0.146426,1,107
"圆佛寂寺",圆佛寂寺,,4,0,4,9,0,9,0,0,0,0,3,0.006198,0.083333,0.217586,1,16
"优雅mooc39",优雅mooc39,,2,1,3,3,1,4,0,0,0,0,3,0.002024,0.5,0.19052,1,15
Clover猎聘顾问,Clover猎聘顾问,,1,0,1,1,0,1,0,0,0,0,3,0.002024,0,0.146426,1,14
"一只受虐的生物雪茄",一只受虐的生物雪茄,,1,0,1,1,0,1,0,0,0,0,3,0.002024,0,0.146426,1,13
"向右转mooc1",向右转mooc1,,1,1,2,1,1,2,2,0.666667,0.75,24,3,0.002024,0,0.146426,1,12
li-mai,li-mai,,0,4,4,0,8,8,2,0.833333,0.9,0,12,0.001803,0,0,1,141
shengmingkexueli163com,shengmingkexueli163com,,1,0,1,2,0,2,0,0,0,0,3,0.002024,0,0.146426,1,9
"制药81汪小龙2183410474-dxf",制药81汪小龙2183410474-dxf,,2,0,2,4,0,4,0,0,0,0,3,0.002799,0,0.149914,1,8
54lx,54lx,,0,2,2,0,4,4,1,1,1,0,3,0.001803,0,0,1,142
"甫亮",甫亮,,5,1,6,10,1,11,2,0.666667,0.75,35,12,0.005423,0.033333,0.221074,1,7
"西农动科176何礼邦2017010737",西农动科176何礼邦2017010737,,0,1,1,0,2,2,3,0.5,0.611111,0,12,0.001803,0,0,1,143
"王林夕王奇",王林夕王奇,,1,0,1,3,0,3,0,0,0,0,3,0.002024,0,0.146426,1,4
the side,the side,,0,1,1,0,1,1,1,1,1,0,3,0.001803,0,0,1,144
mooc39443806561294492,mooc39443806561294492,,0,1,1,0,1,1,1,1,1,0,3,0.001803,0,0,1,145
cellstudy,cellstudy,,1,0,1,1,0,1,0,0,0,0,3,0.002024,0,0.146426,1,3
moochaar,moochaar,,0,2,2,0,4,4,1,1,1,0,3,0.001803,0,0,1,146
"某某mooc109",某某mooc109,,0,1,1,0,2,2,1,1,1,0,3,0.001803,0,0,1,147
"吾木沉香",吾木沉香,,4,0,4,7,0,7,0,0,0,0,12,0.012343,0,0.099035,1,5
mooc45235294495398980,mooc45235294495398980,,1,3,4,1,6,7,1,1,1,2,12,0.002379,0.083333,0.034638,1,25
"小赫本人",小赫本人,,3,1,4,3,1,4,1,1,1,5,12,0.009599,0,0.061915,1,6
ArinHu,ArinHu,,100,0,100,438,0,438,0,0,0,0,13,0.107625,0.001717,1,1,10
"徐苗苗666",徐苗苗666,,0,3,3,0,20,20,1,1,1,0,5,0.001803,0,0,1,148
17水族赵鑫,17水族赵鑫,,0,4,4,0,15,15,1,1,1,0,13,0.001803,0.083333,0,1,149
james_Maxwell,james_Maxwell,,0,2,2,0,8,8,1,1,1,0,13,0.001803,0,0,1,150
"生科-汪源",生科-汪源,,0,3,3,0,12,12,1,1,1,0,13,0.001803,0,0,1,151
"南山公子",南山公子,,0,1,1,0,2,2,1,1,1,0,13,0.001803,0,0,1,152
"小北mooc142",小北mooc142,,0,1,1,0,2,2,1,1,1,0,13,0.001803,0,0,1,153
"覃斯婕",覃斯婕,,0,3,3,0,10,10,1,1,1,0,13,0.001803,0,0,1,154
"橙色晚樱",橙色晚樱,,0,2,2,0,5,5,1,1,1,0,5,0.001803,0,0,1,155
"好好学习啊HTH",好好学习啊HTH,,0,3,3,0,14,14,1,1,1,0,13,0.001803,0,0,1,156
mooc42165351451298114,mooc42165351451298114,,0,1,1,0,11,11,1,1,1,0,13,0.001803,0,0,1,157
G-DKY,G-DKY,,0,1,1,0,2,2,1,1,1,0,13,0.001803,0,0,1,158
"信煊煊得永生",信煊煊得永生,,0,3,3,0,12,12,1,1,1,0,13,0.001803,0,0,1,159
UNIX10,UNIX10,,0,4,4,0,7,7,3,0.493927,0.506831,0,13,0.001803,0.166667,0,1,160
mooc1536575384309,mooc1536575384309,,1,2,3,1,14,15,1,1,1,1,13,0.002578,0.166667,0.003488,1,161
"路句句特洛伊",路句句特洛伊,,0,1,1,0,2,2,1,1,1,0,13,0.001803,0,0,1,162
marugenyan,marugenyan,,0,3,3,0,12,12,1,1,1,0,13,0.001803,0,0,1,163
"朱加琳",朱加琳,,72,0,72,177,0,177,0,0,0,0,5,0.07209,0.001174,0.579461,1,18
"郑海倩",郑海倩,,0,2,2,0,12,12,1,1,1,0,13,0.001803,0,0,1,164
synchronicitymooc,synchronicitymooc,,1,2,3,1,6,7,1,1,1,2,13,0.003353,0,0.003488,1,165
"墨韵mooc11",墨韵mooc11,,1,3,4,1,6,7,1,1,1,1,13,0.002319,0.166667,0.003488,1,166
B5CM201815250523汪江徽,B5CM201815250523汪江徽,,0,1,1,0,1,1,1,1,1,0,5,0.001803,0,0,1,167
mooc68233107067927650,mooc68233107067927650,,1,1,2,1,4,5,1,1,1,0,13,0.002061,0.5,0.003488,1,168
heqixin0503126com,heqixin0503126com,,0,2,2,0,8,8,1,1,1,0,13,0.001803,0,0,1,169
"何清欢i",何清欢i,,0,1,1,0,2,2,1,1,1,0,13,0.001803,0,0,1,170
mooc-DEEPING,mooc-DEEPING,,0,2,2,0,4,4,1,1,1,0,13,0.001803,0,0,1,171
17671447446csh,17671447446csh,,0,2,2,0,4,4,1,1,1,0,13,0.001803,0,0,1,172
FAFU3155002044,FAFU3155002044,,1,1,2,1,4,5,1,1,1,0,13,0.002578,0.5,0.003488,1,173
101黄成膺173,101黄成膺173,,0,2,2,0,32,32,1,1,1,0,13,0.001803,0,0,1,174
"李昊宸Jimmy",李昊宸Jimmy,,0,2,2,0,27,27,1,1,1,0,13,0.001803,0,0,1,175
mooc39368658391322664,mooc39368658391322664,,0,2,2,0,35,35,1,1,1,0,13,0.001803,0,0,1,176
JuniorSky,JuniorSky,,26,0,26,49,0,49,0,0,0,0,13,0.021477,0,0.399455,1,19
"原离",原离,,2,2,4,2,6,8,1,1,1,4,13,0.00457,0.083333,0.071495,1,57
E3泛素连接酶,E3泛素连接酶,,0,3,3,0,6,6,1,1,1,0,13,0.001803,0,0,1,177
Anne爱学习耶,Anne爱学习耶,,0,6,6,0,8,8,1,1,1,0,5,0.001803,0.166667,0,1,179
"午夜电台房小布",午夜电台房小布,,0,3,3,0,4,4,1,1,1,0,13,0.001803,0,0,1,180
"韦尔奇1",韦尔奇1,,0,3,3,0,6,6,1,1,1,0,13,0.001803,0,0,1,181
dangelhao163com,dangelhao163com,,2,3,5,2,7,9,1,1,1,3,13,0.002767,0.15,0.038126,1,20
SQ2017生科靳志远170914003,SQ2017生科靳志远170914003,,0,2,2,0,8,8,1,1,1,0,13,0.001803,0,0,1,182
AsOnemooc2,AsOnemooc2,,0,1,1,0,2,2,1,1,1,0,13,0.001803,0,0,1,183
"武生院生物工程张淼",武生院生物工程张淼,,0,1,1,0,2,2,1,1,1,0,13,0.001803,0,0,1,184
mooc42663545366591271,mooc42663545366591271,,0,1,1,0,4,4,1,1,1,0,13,0.001803,0,0,1,185
"郭佳欣16404027",郭佳欣16404027,,0,2,2,0,5,5,3,0.484127,0.494536,0,13,0.001803,0,0,1,186
"不捉老鼠的猫mooc",不捉老鼠的猫mooc,,0,1,1,0,2,2,1,1,1,0,13,0.001803,0,0,1,187
"呆萌小个儿",呆萌小个儿,,0,1,1,0,4,4,1,1,1,0,13,0.001803,0,0,1,188
j-mooker,j-mooker,,0,3,3,0,7,7,2,0.8,0.875,0,13,0.001803,0.333333,0,1,189
"徐涛XuTao",徐涛XuTao,,0,1,1,0,2,2,1,1,1,0,13,0.001803,0,0,1,190
"生技161–包鑫桧",生技161–包鑫桧,,0,1,1,0,2,2,1,1,1,0,13,0.001803,0,0,1,191
"中医老刘007",中医老刘007,,1,2,3,1,4,5,1,1,1,0,5,0.002061,0.333333,0.003488,1,178
Beyondmooc142,Beyondmooc142,,0,2,2,0,4,4,1,1,1,0,5,0.001803,0,0,1,192
"临床811班颜琦湦2185324567",临床811班颜琦湦2185324567,,0,2,2,0,5,5,2,0.75,0.833333,0,13,0.001803,0.5,0,1,193
"今天我也在学习鸭",今天我也在学习鸭,,0,1,1,0,1,1,1,1,1,0,13,0.001803,0,0,1,194
"陆棹欣",陆棹欣,,0,1,1,0,2,2,1,1,1,0,13,0.001803,0,0,1,195
"什么昵称不能被占用",什么昵称不能被占用,,0,1,1,0,4,4,1,1,1,0,13,0.001803,0,0,1,196
"王小容mooc",王小容mooc,,0,1,1,0,2,2,1,1,1,0,13,0.001803,0,0,1,197
mooc43291564347197815,mooc43291564347197815,,0,2,2,0,4,4,1,1,1,0,5,0.001803,0,0,1,198
mooc41542176565288510,mooc41542176565288510,,0,1,1,0,2,2,1,1,1,0,13,0.001803,0,0,1,199
"斐然季",斐然季,,0,1,1,0,2,2,1,1,1,0,13,0.001803,0,0,1,200
"黄中昱",黄中昱,,0,1,1,0,2,2,1,1,1,0,13,0.001803,0,0,1,201
mooc13029209428320885,mooc13029209428320885,,0,1,1,0,2,2,1,1,1,0,13,0.001803,0,0,1,202
mooc1536656050892,mooc1536656050892,,0,1,1,0,2,2,1,1,1,0,13,0.001803,0,0,1,203
"史宇博",史宇博,,1,1,2,1,2,3,1,1,1,1,13,0.003533,0,0.034638,1,11
"烟雨云窈",烟雨云窈,,0,2,2,0,4,4,1,1,1,0,5,0.001803,0,0,1,204
xhyuanc,xhyuanc,,0,1,1,0,2,2,1,1,1,0,13,0.001803,0,0,1,205
frank4869,frank4869,,0,1,1,0,2,2,1,1,1,0,13,0.001803,0,0,1,206
"陈亚房",陈亚房,,0,2,2,0,4,4,1,1,1,0,5,0.001803,0,0,1,207
linfang0524,linfang0524,,0,2,2,0,4,4,1,1,1,0,5,0.001803,0,0,1,208
mooc73004230462064433,mooc73004230462064433,,0,1,1,0,2,2,1,1,1,0,13,0.001803,0,0,1,209
"啦啦啦wjr",啦啦啦wjr,,0,1,1,0,2,2,1,1,1,0,13,0.001803,0,0,1,210
"倒转流年mooc",倒转流年mooc,,0,2,2,0,4,4,1,1,1,0,5,0.001803,0,0,1,211
"黑龙江农垦红局局直二中李春烨",黑龙江农垦红局局直二中李春烨,,0,2,2,0,4,4,1,1,1,0,5,0.001803,0,0,1,212
"爱学习的萌喵酱",爱学习的萌喵酱,,0,2,2,0,2,2,1,1,1,0,13,0.001803,0.5,0,1,213
"丘山水懿",丘山水懿,,0,1,1,0,2,2,1,1,1,0,5,0.001803,0,0,1,214
"杨力mooc3",杨力mooc3,,0,1,1,0,2,2,1,1,1,0,5,0.001803,0,0,1,215
"段居轩",段居轩,,0,1,1,0,2,2,1,1,1,0,5,0.001803,0,0,1,216
mooc1535369060217,mooc1535369060217,,0,1,1,0,2,2,1,1,1,0,5,0.001803,0,0,1,217
"早起的小虫子",早起的小虫子,,0,1,1,0,2,2,1,1,1,0,5,0.001803,0,0,1,218
"大方芝士",大方芝士,,0,1,1,0,2,2,1,1,1,0,5,0.001803,0,0,1,219
"追mooc146",追mooc146,,0,1,1,0,2,2,1,1,1,0,5,0.001803,0,0,1,220
"梁牧和mooc",梁牧和mooc,,0,1,1,0,2,2,1,1,1,0,5,0.001803,0,0,1,221
"黎咲",黎咲,,0,1,1,0,1,1,1,1,1,0,5,0.001803,0,0,1,222
"天水师院生物学科161张红芳",天水师院生物学科161张红芳,,0,1,1,0,2,2,1,1,1,0,5,0.001803,0,0,1,223
"生物1804胡井泓",生物1804胡井泓,,0,1,1,0,2,2,1,1,1,0,5,0.001803,0,0,1,224
"随艺mooc1",随艺mooc1,,0,1,1,0,2,2,1,1,1,0,5,0.001803,0,0,1,225
"魔法少年小污喵",魔法少年小污喵,,0,1,1,0,2,2,1,1,1,0,5,0.001803,0,0,1,226
mooc1536667147456,mooc1536667147456,,0,1,1,0,2,2,1,1,1,0,5,0.001803,0,0,1,227
m188953282903,m188953282903,,0,1,1,0,3,3,1,1,1,0,5,0.001803,0,0,1,228
mooc39945138868308851,mooc39945138868308851,,0,1,1,0,2,2,1,1,1,0,5,0.001803,0,0,1,229
1803114146 樊琳琳,1803114146 樊琳琳,,0,1,1,0,2,2,1,1,1,0,5,0.001803,0,0,1,230
1521503726qqcom,1521503726qqcom,,0,1,1,0,2,2,1,1,1,0,5,0.001803,0,0,1,231
"李柏宇",李柏宇,,0,1,1,0,2,2,1,1,1,0,5,0.001803,0,0,1,232
"姜姜_88",姜姜_88,,0,1,1,0,1,1,1,1,1,0,5,0.001803,0,0,1,233
"陈文杰3171401050江苏大学",陈文杰3171401050江苏大学,,0,1,1,0,1,1,2,0.666667,0.75,0,13,0.001803,0,0,1,234
mooc45458095037674481,mooc45458095037674481,,0,1,1,0,1,1,3,0.480315,0.489071,0,3,0.001803,0,0,1,235
"刘渠安",刘渠安,,0,1,1,0,1,1,3,0.480315,0.489071,0,3,0.001803,0,0,1,236
"悠茗子",悠茗子,,0,1,1,0,1,1,3,0.480315,0.489071,0,3,0.001803,0,0,1,237
mooc80987183278376727,mooc80987183278376727,,0,2,2,0,2,2,3,0.488,0.497268,0,3,0.001803,0.5,0,1,238
SQ生科160911006苗露,SQ生科160911006苗露,,0,1,1,0,1,1,3,0.5,0.533333,0,3,0.001803,0,0,1,239
"归期一月",归期一月,,0,1,1,0,1,1,2,0.666667,0.75,0,12,0.001803,0,0,1,240
mooc1512593933103,mooc1512593933103,,0,1,1,0,1,1,2,0.666667,0.75,0,12,0.001803,0,0,1,241
MIT2021,MIT2021,,0,1,1,0,2,2,3,0.5,0.566667,0,13,0.001803,0,0,1,242
mooc45975958740105772,mooc45975958740105772,,0,1,1,0,1,1,2,0.6,0.666667,0,13,0.001803,0,0,1,243
